######### ##########
#....#......... ...#
#....              #
  .p.*..   , ,  r..#
#....h             #
#....#..... ... ...#
########## #########