########### ###########
#.....,*....,.........#
#.###.####.#.####.###.#
#......,..........,...#
#.###.#.#######.#.###.#
#.....#....#....#.....#
#####.#### # ####.#####
    #.#         #.#
#####.# ##   ## #.#####
     .  #bgr  #  .
#####.# ####### #.#####
    #.#         #.#
#####.#  #####  #.##*##
#..........#..........#
#.###.####.#.####.###.#
#...#......p.,....#...#
###.#.#.#######.#.#.###
#.....#....#....#.....#
#.########.#.##h#####.#
#...h....,.......,....#
###########.###########